xxxxxxxxxxxxxx
x   x   x    x
x   x   x    x
x       x    x
x       x    x
x   xxxxx    x
x            x
xxxxxxxxxx   x
x            x
x            x
xxxxxxxxxxx xx
x   x   x    x
x   x   x    x
x       x    x
x       x    x
x   xxxxx    x
x            x
x            x
x            x
xxxxxxxxxx   x
x            x
x            x
x            x
xxxxxx xxxxxxx
x   x   x    x
x   x   x    x
x   x   x    x
x       x    x
x       x    x
x   xxxxx    x
x            x
x            x
xxxxxxxxxx   x
x            x
x            x
x            x
xxxxxxxxxxxxxx